000000000000000000000000
000000000000000000000000
000000000000000000000000
000000000000000000000000
000000000000000003050102
000000000000000003050102
000000000000000000000000
000000000000000000000000
000000000000060404030102
000000000000060504030102