040506091213
040506091011
040506090303
040506070808
000102030303